22	28	28	28	28	28	28	28	28	28	28	28	28	28	28	23
20	0	0	0	0	18	5	18	0	18	0	18	5	0	0	21
20	0	0	0	19	0	0	0	19	0	0	0	19	0	0	21
20	18	0	18	7	0	0	0	6	18	0	18	16	0	0	21
20	0	0	0	17	0	0	0	19	0	0	0	0	0	0	21
20	0	0	0	6	0	0	0	19	0	0	11	9	10	0	21
20	0	0	0	19	18	3	18	0	11	9	13	0	8	0	21
20	0	0	15	6	15	16	18	5	12	5	18	2	8	0	21
20	0	15	15	19	15	15	0	19	8	0	0	0	8	0	21
20	0	15	15	0	18	5	18	0	14	9	9	9	13	0	21
20	0	0	0	0	0	0	0	0	0	0	0	0	0	0	21
30	29	29	29	29	29	29	29	29	29	29	29	29	29	29	31